# translation for Simplified Chinese

Shadowsocks=Shadowsocks

# Menu items

Mode=代理模式
No modify system proxy=不修改当前状态
Disable system proxy=直连模式(不代理)
PAC=PAC 模式
Global=全局模式
Proxy rule=代理规则
Bypass LAN=绕过局域网
Bypass LAN and China=绕过局域网和大陆
Bypass LAN and not China=绕过局域网和非大陆
User custom=用户自定义
Disable bypass=全局代理
Edit Host file=编辑用户自定义规则
Edit China IP file=编辑大陆规则
(empty group)=(未分组)
Servers=服务器
Edit servers=编辑服务器
Import servers from file=从文件导入服务器
Servers Subscribe=服务器订阅
Subscribe setting=服务器订阅设置
Update subscribe SSR node=更新服务器订阅
Update subscribe SSR node(bypass proxy)=更新服务器订阅(不代理)
Global settings=选项设置
Start on Boot=开机启动
Allow Clients from LAN=允许来自局域网的连接
Same host for same address=优先连接相同节点
Enable domain white list(http proxy only)=使用域名白名单(仅http代理)
Update local PAC from GFWList=更新 PAC 为 GFWList
Update local PAC from Lan IP list=更新 PAC 为绕过局域网
Update local PAC from Chn White list=更新 PAC 为绕过大陆域名
Update local PAC from Chn IP list=更新 PAC 为绕过大陆 IP
Update local PAC from Chn Only list=更新 PAC 为仅通过大陆域名
Edit local PAC file=编辑 PAC 文件
Edit user rule for GFWList=编辑 GFWList 用户规则
Show QRCode=显示二维码
Scan QRCode from screen=从二维码导入服务器
Import SSR links from clipboard=从剪贴板导入服务器
Server statistic=服务器连接统计
Disconnect current=断开所有连接
Show logs=显示日志
Other=其它
Quit=退出
Edit Servers=编辑服务器
Global Settings=选项设置

# Config Form

&Add=添加(&A)
&Delete=删除(&D)
&Modify=修改(&M)
Up=上移
Down=下移

New server=未配置的服务器

Server=服务器
Server IP=服务器 IP
Server Port=服务器端口
UDP Port=UDP端口
Password=密码
Encryption=加密
Remarks=备注

Adv. Setting=高级选项
Obfs UDP=混淆UDP协议
NOT all server support belows=以下选项不是所有服务端都支持
TCP over TCP if not checked=不打钩使用原生 TCP(暂不能用)
UDP over UDP if not checked=不打钩使用原生 UDP
Recommend checked=保留功能
Protocol=协议
Protocol param=协议参数
Obfs=混淆
Obfs param=混淆参数
SSR Link=SSR链接
Original=原版
Verify all=校验所有数据

Local proxy=本地代理
Build-in http proxy=内置http代理(目前有bug)
Proxy Port=本地端口
Username=用户名
Reconnect Times=重连次数
Connect Timeout=连接超时
TTL=空闲断开秒数

OK=确定
Cancel=取消

# ServerLog Form

ServerLog=服务器记录
&Control=操作(&C)
&Disconnect direct connections=断开直连连接(&D)
Disconnect &All=断开当前所有连接(&A)
Clear &MaxSpeed=重置历史最高(&M)
&Clear=清空(&C)
Clear &Selected Total=清空选中节点历史流量(&S)
Clear &Total=清空所有历史流量(&T)
Port &out=导出(&O)
Copy current link=复制选中链接
Copy current group links=复制选中组链接
Copy all enable links=复制所有开启节点链接
Copy all links=复制所有节点链接
&Window=窗口(&W)
Auto &size=自动调整大小(&S)
Always On &Top=窗口置顶(&T)
Total Connect=总连接
Enable=开关
Connecting=连接
Latency=延迟
Avg DSpeed=下载
Max DSpeed=最高下载
Avg UpSpeed=上传
Max UpSpeed=最高上传
Upload=总上传
Dload=总下载
DloadRaw=实下载
Error=错误
Timeout=超时
Empty Response=空连
Error Percent=出错比例
Continuous=连错
Version=版本

# Global Log Form

Log Viewer=日志查看器

# SubscribeForm Form

Subscribe Settings=订阅设置
URL=网址
Group=分组
Auto update=自动更新
Add=添加
Delete=删除
Modify=修改

# Messages

Shadowsocks Error: {0}=Shadowsocks 错误: {0}
Port already in use=端口已被占用
Illegal port number format=非法端口格式
Please add at least one server=请添加至少一个服务器
Please add at least one server subscribe=请添加至少一个服务器订阅
Server IP can not be blank=服务器 IP 不能为空
Password can not be blank=密码不能为空
Port out of range=端口超出范围
{0} {1} Update Found={0} {1} 更新
Click menu to download=点击菜单项下载
ShadowsocksR is here=ShadowsocksR 在这里
You can turn on/off ShadowsocksR in the context menu=可以在右键菜单中开关 ShadowsocksR
System Proxy Enabled=系统代理已启用
System Proxy Disabled=系统代理未启用
Failed to update PAC file =更新 PAC 文件失败
PAC updated=更新 PAC 成功
No updates found. Please report to GFWList if you have problems with it.=未发现更新。如有问题请提交给 GFWList。
No QRCode found. Try to zoom in or move it to the center of the screen.=未发现二维码，尝试把它放大或移动到靠近屏幕中间的位置
ShadowsocksR is already running.=ShadowsocksR 已经在运行。
Find Shadowsocks icon in your notify tray.=请在任务栏里寻找 ShadowsocksR 图标。
If you want to start multiple Shadowsocks, make a copy in another directory.=如果想启动多份，可以另外复制一份到别的目录。
Failed to decode QRCode=无法解析二维码
Failed to update registry=无法修改注册表
System Proxy On: =系统代理已启用：
Running: Port {0}=正在运行：端口 {0}
Running: =正在运行：
Password NOT match=密码不匹配
Update subscribe SSR node success=SSR 服务器订阅更新成功
Update subscribe SSR node failure=SSR 服务器订阅更新失败
Success=成功
Information=通知
