# translation for Traditional Chinese

# Menu items
Mode=代理模式
No modify system proxy=不修改當前狀態
Disable system proxy=直連模式(不代理)
PAC=PAC 模式
Global=全局模式
Proxy rule=代理規則
Bypass LAN=繞過區域網路
Bypass LAN and China=繞過區域網路和大陸
Bypass LAN and not China=繞過區域網路和非大陸
User custom=用戶自定義
Disable bypass=全局代理
Edit Host file=編輯用戶自定義規則
Edit China IP file=編輯大陸規則
(empty group)=(未分組)
Servers=伺服器
Edit servers=編輯伺服器
Import servers from file=從文件導入伺服器
Config File=設定檔
Servers Subscribe=伺服器訂閱
Subscribe setting=伺服器訂閱設置
Update subscribe SSR node=更新伺服器訂閱
Update subscribe SSR node(bypass proxy)=更新伺服器訂閱(不代理)
Global settings=選項設置
Start on Boot=開機啟動
Allow Clients from LAN=允許來自區域網路的連接
Update local PAC from GFWList=更新 PAC 為 GFWList
Update local PAC from Lan IP list=更新 PAC 為繞過區域網路
Update local PAC from Chn White list=更新 PAC 為繞過大陸域名
Update local PAC from Chn IP list=更新 PAC 為繞過大陸 IP
Update local PAC from Chn Only list=更新 PAC 為僅通過大陸域名
Edit local PAC file=編輯 PAC 文件
Edit user rule for GFWList=編輯 GFWList 用戶規則
Scan QRCode from screen=從 QR 碼導入伺服器
Copy address from clipboard=從剪貼板導入伺服器
Server statistic=伺服器連接統計
Disconnect current=斷開所有連接
Quit=退出
Edit Servers=編輯伺服器
Global Settings=選項設置

# Config Form
Add=添加
Delete=刪除
Modify=修改
Up=上移
Down=下移
New server=未配置的伺服器
Server=伺服器
Server IP=伺服器 IP
Server Port=伺服器連接埠
UDP Port=UDP連接埠
Password=密碼
Encryption=加密
Remarks=備註
Adv. Setting=高級選項
Obfs UDP=混淆UDP協議
NOT all server support belows=以下選項不是所有伺服器都支持
TCP over TCP if not checked=不打勾使用原生 TCP(暫不能用)
UDP over UDP if not checked=不打勾使用原生 UDP
Recommend checked=保留功能
Protocol=協議
Protocol param=協議參數
Obfs=混淆
Obfs param=混淆參數
SSR Link=SSR連結
Local proxy=本地代理
Username=用戶名
Proxy Port=本地連接埠
Reconnect Times=重連次數
Connect Timeout=連接超時
TTL=空閒斷開秒數
OK=確定
Cancel=取消

# ServerLog Form
ServerLog=伺服器記錄
Clear=清空
Total Connect=總連接
Enable=開關
Connecting=連接
Latency=延遲
Avg DSpeed=下載
Max DSpeed=最高下載
Avg UpSpeed=上傳
Max UpSpeed=最高上傳
Upload=總上傳
Dload=總下載
DloadRaw=實下載
Error=錯誤
Timeout=超時
Empty Response=空連
Error Percent=出錯比例
Continuous=連錯
Version=版本

# SubscribeForm Form
Subscribe Settings=訂閱設置
URL=網址
Group=分組
Auto update=自動更新

# Messages
Shadowsocks Error: {0}=Shadowsocks 錯誤: {0}
Port already in use=連接埠已被占用
Illegal port number format=非法連接埠格式
Please add at least one server=請添加至少一個伺服器
Please add at least one server subscribe=請添加至少一個伺服器訂閱
Server IP can not be blank=伺服器 IP 不能為空
Password can not be blank=密碼不能為空
Port out of range=連接埠超出範圍
System Proxy Enabled=系統代理已啟用
System Proxy Disabled=系統代理未啟用
Failed to update PAC file =更新 PAC 文件失敗
PAC updated=更新 PAC 成功
No updates found. Please report to GFWList if you have problems with it.=未發現更新。如有問題請提交給 GFWList。
No QRCode found. Try to zoom in or move it to the center of the screen.=未發現 QR 碼，嘗試把它放大或移動到靠近屏幕中間的位置
ShadowsocksR is already running=ShadowsocksR 已在運行
Find Shadowsocks icon in your notify tray.=請在工作列裡尋找 ShadowsocksR 圖標。
If you want to start multiple Shadowsocks, make a copy in another directory.=如果想啟動多份，可以另外複製一份到別的目錄。
Failed to decode QRCode=無法解析 QR 碼
Failed to update registry=無法修改註冊表
System Proxy On: =系統代理已啟用：
Running: Port {0}=正在運行：連接埠 {0}
Running: =正在運行：
Password NOT match=密碼不匹配
Update subscribe SSR node success=SSR 伺服器訂閱更新成功
Update subscribe SSR node failure=SSR 伺服器訂閱更新失敗
Success=成功
Information=通知
